*************************************************** *************************************************
*         *                         *       *   * *       *       * *                       * *     *
* ******* * ***** *** * * * ******* * ******* *** * * *** * ***** * *** ******************* * * *****
* * *       *   *   * * * *   *   *               * * * * * *           * *         * *         *   *
* * * ********* *** ***** ******* *** *** ***** * * * * * * ***** *** * * ***** ***** ********* * * *
*   *       *   * * *     *         * * * *   * * * *   *   *     *   *     *     *   *     * *   * *
***** * * * * *** * *** *** ***** *** * ***** * * * * * ***** ********* * * *** ***** ***** * * *** *
*     * * * *         * * *     * *       *   * *   * * *     *     * * * *   *     *       *   *   *
* *** ******* ******* * * * ***** *** *** * *** * * * ********* *** * * ******* ******* * * * * * * *
*   * * * * *   * * * *   *   *   * * *   * * * * * * *           *     * * * * *   * * *     * * * *
* ***** * * * *** * *** *** *** * * * *** * * *********** ***** *** * * * * * * * * * *** ******* ***
* *     *     *     *       *   * *     * *       *   *   *   * * * * *   * *     * * * * * *   *   *
* ***** *** * * ***** ***** ******* ******* * * *** *** *** ***** * ***** * ***** *** * * * * * *** *
* *     *   * *       *     *       * *     * *   * *   * *     *   * * * *   *     * * *   * * *   *
* ***** * * * ******* *** * * *** *** ******* * *** *** * ***** ***** * * * ***** *** * *** * ***** *
* *   *   * * * *       * * * *   *           *     *   *   *     * * *   *       * *             * *
* *** * ***** * *** *** *** *** * *** ***** * *** *** ***** * ***** * ***** ***** * ******* ***** ***
*       * *       * * *   *   * * *   *   * * * * * *   *       *     * * * * *     *     * *       *
* ******* * *** * *** * * * * * ***** *** * *** *** *** * * * *** *** * * *** * ***** * * *** *** * *
* *     *     * *   * * * * *       *   *   *           * * *   *   * *       * *     * * *     * * *
* ***** ******* ***** *** ***** * * * *** * ***** * *********** ***** * *** * * ********* * ******* *
* *     *   *     * *   *     * * * * *   *   * * * * *     *   *         * *   * *           * *   *
* * *** * ***** *** * *** ******* ********* *** * * * *** *** ******* *** ******* ******* *** * *** *
* *   *     * *     *   *     *   *   * * * * *   *   *           * * *   *   * *       * * *     * *
* * *** * * * *** ***** * ***** ***** * * * * ***** * ********* *** *** ***** * * *** * *** * *** * *
* *   * * *   *       *     *         *   *         *     *   * *   * *   *   *   *   * *   * *   * *
* ********* ********* *** *** * * ******* ***** * ******* * * * *** * * ***** *** *** * *** * ***** *
* * *     *         * *     * * *       * *     *   * *   * * * *       * *     * * * *     *   * * *
* * ***** ***** *********** ***** * ***** *** * *** * ***** * * * ***** * * ***** * * *** *** * * * *
* * *                 * * *   *   *   *       *   * * *     *   *   *     * * *   *   * *     *     *
* * *** *** ********* * * * *** *** * * * *** *** *** * *** ******* ***** * * * *** *** * *** * *** *
*   *     * * *         * * *   * * *   *     *   *     * *   *   *   *   *   * *   *     *   *   * *
* ********* * * ***** *** * ***** *************** *** * * * * *** * ******* * * *********** ***** * *
*     *   * *     *     *           *   *     *       *   * *   *       * * *   * *   *   *     * * *
* ***** *************** * * ***** * * ***** ******* * * ***** ***** *** * * *** * *** *** * ***** * *
*   *   *       * *     * *   *   * * *         *   * * *     *     * * *     * * *       *     * * *
* *** ***** * * * * *** *** ***** *** * *** ***** * * ***** ******* * * * * * *** * *** * ******* * *
*       *   * *       *   *   * * * *     * * * * * * * *   *   *     * * * * * * *   * * *   * * * *
******* * * *** *** ***** *** * *** *** ***** * * *** * ***** *** ********* * * * * ******* * * *** *
*   *     *       * * *   *   *     * *     *       *   *             *     *   *     *     * *     *
* ********* * * ***** ******* *** *** * *** * *** * * ********* * * * *** * *** *** *** * ***** *****
*           * * *       *     * *       *       * * * * *   * * * * * *   * *   * *   * *   * *     *
* ************* * *********** * * * ******* ***** ***** * * * *** * * ******* *** *** * * *** *** ***
* * *                   *       * * * * * * * *   *       *   *   * * *   *   *       * *   *     * *
* * * ******* *** *** * *** ******* * * * *** *** * * ******* * *** *** * *** ******* * ******* *** *
*   *   *       *   * *     *     * *         *     *     *     *       *   *   *   *   *     *     *
* ********* * ***** ***** ***** * ***** *** * * *** *************** ******* * ***** * * * * *** *** *
* *       * * * * * *   *   *   * *       * *     *     * *   * *         *   *         * * *   *   *
* * *** ***** * * ***** * ***** ******* *** * * ***** *** *** * ***** ***** *** ***** *** ***** * * *
* * * *   *   * *       *   * *     * * *   * * *   *   * * *   *         *     * *   *   * * * * * *
* *** *** *** * * * * ***** * *** * * *** *** * * * * *** * * * * *** * *** *** * * *** * * * * * * *
*   *       * *   * *   *     *   * *     * * * * *       * * * *     * * * *       *   * *   * * * *
* *** * ***** * ***** *** * ******* * * *** * *** * * ***** * * * * ***** ******* ***** *** * ***** *
* *   *   * *       * *   * *   *     * *   * *   * *   * *   * * *   * * * *       * *     * *     *
* *** ***** *** * * * ********* ***** * *** ***** * * *** ***** ******* * * *** ***** * ******* *** *
* * *   *       * * *   * * *       * *       *   * *   *   *         *   * *       *   *     *   * *
* * *** * ***** * * ***** * * ************* *** * *** * *** * *** ******* * * *** *** * ***** * *** *
* * *     * * * * *   *   * * * *     * * *   * * *   * *   * *   * *     * * *   *   * *         * *
* * *** *** * * * * * * *** * * ***** * * ******* *** ***** *** *** * *** * * * *** ********* ***** *
*   * *   * *   * * *       * *     *   *     *   *   *     *   *     *   *   * *   *       * *     *
* *** *** * *** *** *** * *** ***** * ***** ******* *** ***** ******* *** *** ***** * *********** ***
*   * *   *       * * * *   *   *         * * * * *     * *   * *   *   * *     * *   * *       * * *
* *** ***** * * *** * ********* * *** * *** * * * *** * * *** * * *** ***** * *** * *** * *** * * * *
*           * *   * *   *     * * * * * *     *     * *           *   *   * *   * *       *   *     *
* *** * * *** ***** *** ***** * * * ******* ***** *** * *** *** *** *** * * * * * * *************** *
*   * * * * *     *                           *   *   * *   * *   * * * *     *     *     *     *   *
* * * * *** *** * * * ***************** * ***** * * ******* * *** * * ***** ***** *** * *** ******* *
* * * *   *     * * * *             *   * * *   *         *     * *       *     *   * *     * * * * *
* ***** ******* ******* * ***** *** ***** * *** ************* *** *** ***** ******* *** *** * * * * *
* *       *   *         * *       * * *     *     *     *   *   *   * *   *   * * *   * * *     *   *
* *** ******* ***** * ***** * ***** * *** * * ***** * * * * * ***** * * ******* * *** * * *** *** ***
*   *   * * * *   * *     * * *       * *         * * * * *     * *             *   *   * * *     * *
* * ***** * * * *** * * *** * *** ***** *** *** *** ***** ******* ********* *** * *** * * * ******* *
* * *   *         * * * *   * * *   * *   *   *   * * * * *     *   *       * *       * *       *   *
******* ***** ********* *** *** ***** * *** *** *** * * * * *** * ********* * * ***** *** * *** * * *
*       * * *     * * * *         * *         *     * *     * *         *     *   *     * * *     * *
* * *** * * ***** * * * ***** ***** * * *** ******* * * ***** *********** * ***** * *** *** ***** * *
*   *   * * * *           *   *       * *   *     *   *     * *   *   * * *     * *   * *       * * *
*** * *** * * *** *** ***** *** *** * *** * * ***** * *** *** * ***** * * ************* *** * ***** *
*   * *   * *   *   *     *   *   * * * * * * * * *     *                 * * *     * * *   * *   * *
* ******* * *** ********* * * ******* * *** * * * * ***** *** * ***** ***** * *** *** * * * * * *** *
*     *   *       * * *     * *   *     *   * *         * * * *   *   *       * * *       * *   *   *
* *** * * *** ***** * * *** *** * ******* *** *** ******* * ***** ***** ***** * * ***** ***** ***** *
* * * * * * *         *   *   * *   *   *   *   *     * * * * *   * * *   * * *         *   * * *   *
* * ***** * * ******* *** * * * ***** ***** *** ***** * *** * * *** * ***** * *** * * ***** *** * ***
* *           *     *     * *   *     *   *       * * * *   *   * *     *         * *   *     *     *
* ***** ***** * ******************* * * ******* *** *** * * * * * *** ***** *********** *** * * *** *
* *   * * * * *             *   *   *         *     *   * *   * *   * * *   *     *   * * * *   * * *
* * *** * * *** * * *** ******* * * ********* * * *** *** ***** * * * * * * * *** * * *** * *** * * *
* *     *     * * * *     * * * * *     *       * *     * *   *   * * * * *     * * * *   *   *   * *
* ***** *** * *** ********* * * * ***** ***** * ***** ******* * * *** * ********* *** *** * ******* *
* *     *   * * *   *     *   *   *   * *     *         * *   * * * * * * *     * *     *   *     * *
* * * * *** *** * * * ******* * ***** *** ********* *** * *** *** * * * * *** *** * *** * *** ***** *
*   * * * *   * * *       * *         *       * * *   * * * *   * *   *       * *     * *     * * * *
* * ***** *** * * ***** *** * * * ********* * * * * * *** * *** * * *** *** * * *** * ******* * * * *
* *     *   *         * *   * * * *   * *   *   *   *       *   *   *   * * *     * *     * *       *
* ********* * * ******* * *** ******* * ***** * * ******* *** * *** * *** *** ******* * * * * *******
*   * *   *   *   *     *     *     *   *   * * *     * *   *   *   * *   *           * *   * *     *
*** * *** * ***** *** ***** * * ***** ***** *********** *** *** *** * * *** ***** * *** * *** ***** *
*           *     *         *                               *         *     *     * *   * *         *
************************************************** **************************************************
